BBBBBBBBBBBBBBBBBBBB
B                  B
B                  B
B        BBBBBBBBBBB
B   B              B
B                  B
B           BBBBBBBB
B                  B
B      B           B
B                  B
B   B             BB
B                BBB
BB    BBBBBB    BBBB
B              BBBBB
BBBBBBBBBBBBBBBBBBBB