BBBBBBBBBBBBBBBBBBBBBBBBBBBBBBBBBBBBBBBB
B                  B                   B
B                  B                   B
B                  B                   B
B                  B                   B
B                  B                   B
B                  BB                  B
B                   BBBBB      BBBBBBBBB
B                                      B
B                  BBBBBBBB  BBBBBBBBB B
B                  BBBBBBBB  BBBBBBBBB B
B                  BBBBBBBB  BBBBBBBBB B
B                  BBBBBBBB  BBBBBBBBB B
B                  BBBBBB      BBBBBBB B
B        BBBBBBBBBBBBBBBB      BBBBBBB B
B   B              BBBBBB      BBBBBBB B
B                              BBBBBBB B
B           BBBBBBBBBBBBBBBBBBBBBBBBBB B
B                  BBBBBBBBBBBBBBBBBBB B
B      B           BBBBBBBBBBBBBBBBBBB B
B                                      B
B   B             BBBB                 B
B                BBBBBB                B
BB    BBBBBB    BBBBBBBB               B
B              BBBBBBBBBB              B
BBBBBBBBBBBBBBBBBBBBBBBBBBBBBBBBBBBBBBBB